##########
#....@...#
#.#.#.#..#
#...#....#
#.#.#####.
#.........
#.#.#####.
#.........
##########