##########
#........#
#.#####..#
#.#.....##
#.#.###..#
#...#....#
###.#####.#
#....@....#
##########